Sede di Tappa,Partenze,Arrivi,Totale,Ultima apparizione,Località,Comune
Milano,56,86,142,2017,Milano,Milano
Roma,57,48,105,2018,Roma,Roma
Torino,36,40,76,2016,Torino,Torino
Genova,34,32,66,2015,Genova,Genova
Napoli,31,32,63,2013,Napoli,Napoli
Firenze,30,31,61,2017,Firenze,Firenze
Bologna,27,24,51,2019,Bologna,Bologna
Verona,22,21,43,2019,Verona,Verona
Bari,20,19,39,2014,Bari,Bari
Trieste,18,21,39,2014,Trieste,Trieste
Foggia,20,17,37,1999,Foggia,Foggia
Trento,22,15,37,2018,Trento,Trento
Pescara,17,18,35,2013,Pescara,Pescara
Brescia,16,17,33,2013,Brescia,Brescia
Saint-Vincent,17,13,30,2019,Saint-Vincent,Saint-Vincent
Perugia,15,13,28,1995,Perugia,Perugia
Rieti,17,11,28,2003,Rieti,Rieti
Montecatini Terme,15,13,28,2015,Montecatini Terme,Montecatini-Terme
Potenza,14,13,27,2008,Potenza,Potenza
Campobasso,14,12,26,2002,Campobasso,Campobasso
Sanremo,12,13,25,2015,Sanremo,Sanremo
Treviso,13,12,25,2019,Treviso,Treviso
Chieti,14,10,24,2009,Chieti,Chieti
Arezzo,12,12,24,2016,Arezzo,Arezzo
Cuneo,13,11,24,2019,Cuneo,Cuneo
Forte dei Marmi,10,13,23,1998,Forte dei Marmi,Forte dei Marmi
Bolzano / Bozen,10,13,23,2003,Bolzano,Bolzano/Bozen
Forlì,13,10,23,2017,Forlì,Forlì
Cosenza,11,10,21,2013,Cosenza,Cosenza
Modena,12,9,21,2019,Modena,Modena
San Marino,8,13,21,2019,San Marino,Estero
Mantova,10,10,20,1989,Mantova,Mantova
Ancona,11,9,20,1999,Ancona,Ancona
Palermo,10,10,20,2008,Palermo,Palermo
Parma,11,9,20,2011,Parma,Parma
L'Aquila ,10,10,20,2019,L'Aquila ,L'Aquila
Rimini,11,8,19,1987,Rimini,Rimini
San Pellegrino Terme,9,10,19,2011,San Pellegrino Terme,San Pellegrino Terme
Salsomaggiore Terme,8,11,19,2014,Salsomaggiore Terme,Salsomaggiore Terme
Grosseto,10,9,19,2015,Grosseto,Grosseto
Catania,11,8,19,2018,Catania,Catania
Ferrara,10,9,19,2018,Ferrara,Ferrara
Udine,9,9,18,2007,Udine,Udine
Bassano del Grappa,10,8,18,2014,Bassano del Grappa,Bassano del Grappa
Vicenza,8,10,18,2015,Vicenza,Vicenza
Venezia,9,8,17,2009,Venezia,Venezia
La Spezia,10,7,17,2015,La Spezia,La Spezia
Pisa,7,9,16,1980,Pisa,Pisa
Terni,9,7,16,1995,Terni,Terni
Viareggio,9,7,16,2002,Viareggio,Viareggio
Salerno,7,9,16,2007,Salerno,Salerno
Livorno,7,9,16,2011,Livorno,Livorno
Vittorio Veneto,7,9,16,2014,Vittorio Veneto,Vittorio Veneto
Fiuggi,7,9,16,2015,Fiuggi,Fiuggi
Ravenna,8,8,16,2019,Ravenna,Ravenna
Lucca,8,7,15,1985,Lucca,Lucca
Teramo,6,9,15,2011,Teramo,Teramo
Benevento,7,8,15,2016,Benevento,Benevento
Prato,7,7,14,2000,Prato,Prato
Alessandria,8,6,14,2006,Alessandria,Alessandria
Padova,7,7,14,2009,Padova,Padova
Cesenatico,7,7,14,2010,Cesenatico,Cesenatico
Roccaraso,7,7,14,2016,Roccaraso,Roccaraso
Messina,5,9,14,2017,Messina,Messina
Siena,6,7,13,1986,Siena,Siena
Merano / Meran,8,5,13,2003,Merano,Merano/Meran
Sorrento,8,5,13,2013,Sorrento,Sorrento
Reggio Calabria,8,5,13,2017,Reggio Calabria,Reggio di Calabria
Bormio,7,6,13,2017,Bormio,Bormio
Reggio Emilia,7,6,13,2017,Reggio Emilia,Reggio nell'Emilia
Riva del Garda,8,5,13,2018,Riva del Garda,Riva del Garda
Como,6,7,13,2019,Como,Como
Lanciano,5,7,12,1999,Lanciano,Lanciano
Selva di Val Gardena / Wolkenstein in Gröden,6,6,12,2000,Selva di Val Gardena,Selva di Val Gardena/Wolkenstein in Gröden
Avellino,8,4,12,2010,Avellino,Avellino
Cortina d'Ampezzo - Col Druscié,7,5,12,2012,Cortina d'Ampezzo,Cortina d'Ampezzo
Sulmona,7,5,12,2016,Sulmona,Sulmona
Catanzaro,6,6,12,2016,Catanzaro,Catanzaro
Bergamo,5,7,12,2017,Bergamo,Bergamo
Vasto,7,5,12,2019,Vasto,Vasto
Pinerolo,5,7,12,2019,Pinerolo,Pinerolo
Sondrio,7,4,11,2008,Sondrio,Sondrio
Jesolo,6,5,11,2015,Jesolo,Jesolo
Corvara in Badia / Corvara,5,6,11,2016,Corvara in Badia,Corvara in Badia/Corvara
Pesaro,6,5,11,2019,Pesaro,Pesaro
Riccione,6,5,11,2019,Riccione,Riccione
Ascoli Piceno,5,5,10,2004,Ascoli Piceno,Ascoli Piceno
Chianciano Terme,5,5,10,2010,Chianciano Terme,Chianciano Terme
Orvieto,4,6,10,2011,Orvieto,Orvieto
Belluno,7,3,10,2014,Belluno,Belluno
Taranto,4,6,10,2014,Taranto,Taranto
Campitello Matese,3,7,10,2015,Campitello Matese,San Massimo
Bibione,5,5,10,2016,Bibione,San Michele al Tagliamento
Auronzo di Cadore,5,4,9,1981,Auronzo di Cadore,Auronzo di Cadore
Scanno,4,5,9,1993,Scanno,Scanno
Caserta,5,4,9,2002,Caserta,Caserta
Camaiore,5,4,9,2009,Camaiore,Camaiore
Terminillo,0,9,9,2010,Terminillo,Rieti
Frosinone,5,4,9,2014,Frosinone,Frosinone
Savona,4,5,9,2014,Savona,Savona
Marostica,6,3,9,2015,Marostica,Marostica
Aprica,2,7,9,2015,Aprica,Aprica
Asiago,4,5,9,2017,Asiago,Asiago
Agrigento,5,4,9,2018,Agrigento,Agrigento
Comacchio,4,4,8,1983,Comacchio,Comacchio
Mondovì,5,3,8,1995,Mondovì,Mondovì
Il Ciocco - Barga,4,4,8,1995,Castelvecchio Pascoli,Barga
Macerata,4,4,8,1998,Macerata,Macerata
Cavalese,5,3,8,2001,Cavalese,Cavalese
Rovigo,3,5,8,2001,Rovigo,Rovigo
Varazze,4,4,8,2005,Varazze,Varazze
Aosta,5,3,8,2006,Aosta,Aosta
Varese,4,4,8,2008,Varese,Varese
Levico Terme,5,3,8,2010,Levico Terme,Levico Terme
Maddaloni,5,3,8,2011,Maddaloni,Maddaloni
Matera,3,5,8,2013,Matera,Matera
Foligno,5,3,8,2017,Foligno,Foligno
Assisi,4,4,8,2018,Assisi,Assisi
Terracina,4,4,8,2019,Terracina,Terracina
Frascati,2,6,8,2019,Frascati,Frascati
Santa Margherita Ligure,3,4,7,1977,Santa Margherita Ligure,Santa Margherita Ligure
Lecco,4,3,7,1984,Lecco,Lecco
Senigallia,4,3,7,1993,Senigallia,Senigallia
Imperia,4,3,7,1998,Imperia,Imperia
Meda,4,3,7,2000,Meda,Meda
Gorizia,4,3,7,2001,Gorizia,Gorizia
Asti,3,4,7,2003,Asti,Asti
Biella,5,2,7,2007,Biella,Biella
Spoleto,4,3,7,2007,Spoleto,Spoleto
Cesena,6,1,7,2008,Cesena,Cesena
Carrara,4,3,7,2010,Carrara,Carrara
Urbino,4,3,7,2012,Urbino,Urbino
Rocca di Cambio,3,4,7,2012,Rocca di Cambio,Rocca di Cambio
Sestri Levante,2,5,7,2015,Sestri Levante,Sestri Levante
Moena,5,2,7,2017,Moena,Moena
Pordenone,5,2,7,2017,Pordenone,Pordenone
Tirano,4,3,7,2017,Tirano,Tirano
Terme Luigiane,2,5,7,2017,Terme Luigiane,Acquappesa
Blockhaus - Majelletta,1,6,7,2017,Blockhaus,Pretoro
Novi Ligure,3,4,7,2019,Novi Ligure,Novi Ligure
Abano Terme,3,3,6,1957,Abano Terme,Abano Terme
Gardone Riviera,3,3,6,1958,Gardone Riviera,Gardone Riviera
San Benedetto del Tronto,3,3,6,1964,San Benedetto del Tronto,San Benedetto del Tronto
Casciana Terme,3,3,6,1971,Casciana Terme,Casciana Terme Lari
Pieve di Cadore,3,3,6,1979,Pieve di Cadore,Pieve di Cadore
Pietrasanta,3,3,6,1995,Pietrasanta,Pietrasanta
Arco,3,3,6,2003,Arco,Arco
Avezzano,3,3,6,2003,Avezzano,Avezzano
Lecce,3,3,6,2003,Lecce,Lecce
Viterbo,3,3,6,2005,Viterbo,Viterbo
Francavilla al Mare,3,3,6,2006,Francavilla al Mare,Francavilla al Mare
Cremona,2,4,6,2006,Cremona,Cremona
Briancon,3,3,6,2007,Briancon,Estero
Cava de' Tirreni,3,3,6,2010,Cava de' Tirreni,Cava de' Tirreni
Alba,4,2,6,2011,Alba,Alba
Lienz,4,2,6,2011,Lienz,Estero
Sestriere,0,6,6,2011,Sestriere,Sestriere
Gabicce Mare,4,2,6,2013,Gabicce Mare,Gabicce Mare
Tre Cime di Lavaredo,0,6,6,2013,Tre Cime di Lavaredo,Auronzo di Cadore
Rapallo,3,3,6,2015,Rapallo,Rapallo
Verbania,3,3,6,2015,Verbania,Verbania
Abetone,2,4,6,2015,Abetone,Abetone Cutigliano
Oropa,0,6,6,2017,Oropa,Biella
Osimo,3,3,6,2018,Osimo,Osimo
Rovereto,2,4,6,2018,Rovereto,Rovereto
Monte Zoncolan,0,6,6,2018,Monte Zoncolan,Ovaro
Montevergine di Mercogliano,0,6,6,2018,Montevergine di Mercogliano,Mercogliano
San Martino di Castrozza,2,4,6,2019,San Martino di Castrozza,Primiero San Martino di Castrozza
Cattolica,2,3,5,1978,Cattolica,Cattolica
Isernia,3,2,5,1989,Isernia,Isernia
Taormina,1,4,5,1989,Taormina,Taormina
Follonica,2,3,5,1994,Follonica,Follonica
Loreto,2,3,5,1995,Loreto,Loreto
Baselga di Piné,3,2,5,1997,Baselga di Piné,Baselga di Pinè
Cervia,2,3,5,1997,Cervia,Cervia
Lumezzane,2,3,5,1999,Lumezzane,Lumezzane
Pavia,2,3,5,2003,Pavia,Pavia
Pistoia,1,4,5,2005,Pistoia,Pistoia
Monte Bondone,0,5,5,2006,Monte Bondone,Trento
Arabba,3,2,5,2008,Arabba,Livinallongo del Col di Lana
Locarno,2,3,5,2008,Locarno,Estero
Faenza,2,3,5,2009,Faenza,Faenza
Conegliano,3,2,5,2011,Conegliano,Conegliano
Busto Arsizio,3,2,5,2012,Busto Arsizio,Busto Arsizio
Porto Sant'Elpidio,3,2,5,2012,Porto Sant'Elpidio,Porto Sant'Elpidio
Alpe di Pampeago,0,5,5,2012,Alpe di Pampeago,Tesero
Sansepolcro,3,2,5,2013,Sansepolcro,Sansepolcro
Ponte di Legno - Tonale,2,3,5,2014,Ponte di Legno,Ponte di Legno
Pinzolo,3,2,5,2015,Pinzolo,Pinzolo
Lugano,2,3,5,2015,Lugano,Estero
Castrovillari,3,2,5,2017,Castrovillari,Castrovillari
Cagliari,1,4,5,2017,Cagliari,Cagliari
Peschici,1,4,5,2017,Peschici,Peschici
Iseo,2,3,5,2018,Iseo,Iseo
Bardonecchia - Jafferau,1,4,5,2018,Bardonecchia,Bardonecchia
Imola,1,4,5,2018,Imola,Imola
Cervinia,0,5,5,2018,Cervinia,Valtournenche
Etna - Rifugio Sapienza,0,4,4,2017,Etna,Nicolosi
Etna - Serra La Nave,0,1,1,2018,Etna,Belpasso
Gran Sasso d'Italia,0,5,5,2018,Gran Sasso d'Italia,L'Aquila
Feltre,4,1,5,2019,Feltre,Feltre
Sankt Moritz,2,2,4,1954,Sankt Moritz,Estero
Acqui Terme,2,2,4,1955,Acqui Terme,Acqui Terme
Diano Marina,2,2,4,1966,Diano Marina,Diano Marina
Mirandola,2,2,4,1970,Mirandola,Mirandola
Zingonia,2,2,4,1970,Zingonia,Verdellino
Carpegna - Monte Carpegna,2,2,4,1974,Carpegna,Carpegna
Silvi,2,2,4,1978,Silvi,Silvi
Bellaria,2,2,4,1987,Bellaria,Bellaria-Igea Marina
Lerici,2,2,4,1987,Lerici,Lerici
Madesimo,2,2,4,1987,Madesimo,Madesimo
Arta Terme,2,2,4,1988,Arta Terme,Arta Terme
Borgo Valsugana,2,2,4,1988,Borgo Valsugana,Borgo Valsugana
Rodi Garganico,2,2,4,1988,Rodi Garganico,Rodi Garganico
Vieste,2,2,4,1988,Vieste,Vieste
Voghera,3,1,4,1989,Voghera,Voghera
Corvara in Badia/Corvara,2,2,4,1990,Dobbiaco,Dobbiaco/Toblach
Città di Castello,2,2,4,1991,Città di Castello,Città di Castello
Sassari,2,2,4,1991,Sassari,Sassari
Latina,2,2,4,1992,Latina,Latina
Vigevano,2,2,4,1992,Vigevano,Vigevano
Portoferraio,1,3,4,1993,Portoferraio,Portoferraio
Crotone,2,2,4,1996,Crotone,Crotone
Ostuni,2,2,4,1996,Ostuni,Ostuni
Massa,1,3,4,1996,Massa,Massa
Boario Terme,3,1,4,1999,Boario Terme,Darfo Boario Terme
Castelfranco Veneto,2,2,4,1999,Castelfranco Veneto,Castelfranco Veneto
Lignano Sabbiadoro,3,1,4,2000,Lignano Sabbiadoro,Lignano Sabbiadoro
Giulianova,3,1,4,2001,Giulianova,Giulianova
Arona,2,2,4,2001,Arona,Arona
Salò,2,2,4,2001,Salò,Salò
Passo Pordoi,0,4,4,2001,Passo Pordoi,Canazei
Verviers,3,1,4,2002,Verviers,Estero
Numana,2,2,4,2002,Numana,Numana
Policoro,3,1,4,2004,Policoro,Policoro
Livigno,2,2,4,2005,Livigno,Livigno
Piacenza,2,2,4,2006,Piacenza,Piacenza
Pontedera,2,2,4,2006,Pontedera,Pontedera
Mendrisio,3,1,4,2008,Mendrisio,Estero
Tivoli,2,2,4,2008,Tivoli,Tivoli
Arenzano,2,2,4,2009,Arenzano,Arenzano
Amsterdam,3,1,4,2010,Amsterdam,Estero
Novara,3,1,4,2010,Novara,Novara
San Vigilio di Marebbe / St. Vigil in Enneberg,3,1,4,2010,San Vigilio di Marebbe,Marebbe/Enneberg
Morbegno,3,1,4,2011,Morbegno,Morbegno
Termoli,2,2,4,2011,Termoli,Termoli
Herning,2,2,4,2012,Herning,Estero
Falzes / Pfalzen,1,3,4,2012,Falzes,Falzes/Pfalzen
Fano,1,3,4,2012,Fano,Fano
Passo dello Stelvio,0,4,4,2012,Passo dello Stelvio,Bormio
Longarone,3,1,4,2013,Longarone,Longarone
Belfast,2,2,4,2014,Belfast,Estero
Gemona del Friuli,2,2,4,2014,Gemona del Friuli,Gemona del Friuli
Chiavari,3,1,4,2015,Chiavari,Chiavari
Civitanova Marche,3,1,4,2015,Civitanova Marche,Civitanova Marche
San Giorgio del Sannio,2,2,4,2015,San Giorgio del Sannio,San Giorgio del Sannio
Sestola,1,3,4,2016,Sestola,Sestola
Cefalù,4,0,4,2017,Cefalù,Cefalù
Olbia,3,1,4,2017,Olbia,Olbia
Canazei,1,3,4,2017,Canazei,Canazei
Ortisei / St. Ulrich,1,3,4,2017,Ortisei,Ortisei/St. Ulrich
Praia a Mare,2,2,4,2018,Praia a Mare,Praia a Mare
Carpi,2,2,4,2019,Carpi,Carpi
Campione d'Italia,2,1,3,1968,Campione d'Italia,Campione d'Italia
Biandronno,1,2,3,1970,Biandronno,Biandronno
Parabiago,2,1,3,1972,Parabiago,Parabiago
Bolsena,2,1,3,1973,Bolsena,Bolsena
Formia,2,1,3,1974,Formia,Formia
Pompei,1,2,3,1974,Pompei,Pompei
Siracusa,1,2,3,1976,Siracusa,Siracusa
Bosco Chiesanuova,0,3,3,1979,Bosco Chiesanuova,Bosco Chiesanuova
Orta San Giulio,1,2,3,1983,Orta San Giulio,Orta San Giulio
Erba,2,1,3,1986,Erba,Erba
Sala Consilina,2,1,3,1990,Sala Consilina,Sala Consilina
Lodi,1,2,3,1990,Lodi,Lodi
Montepulciano,2,1,3,1992,Montepulciano,Montepulciano
Fabriano,1,2,3,1993,Fabriano,Fabriano
Melfi,1,2,3,1994,Melfi,Melfi
Nizza / Nice,2,1,3,1998,Nice,Estero
Monte Argentario,1,2,3,1998,Monte Argentario,Monte Argentario
Monte Sirino,0,3,3,1999,Monte Sirino,Lagonegro
Sirmione,2,1,3,2001,Sirmione,Sirmione
Ljubljana,1,2,3,2001,Ljubljana,Estero
Groningen,2,1,3,2002,Groningen,Estero
Köln,2,1,3,2002,Köln,Estero
Vicoforte,2,1,3,2003,Vicoforte,Vicoforte
Cles,2,1,3,2004,Cles,Cles
Porretta Terme,2,1,3,2004,Porretta Terme,Alto Reno Terme
Alleghe,2,1,3,2005,Alleghe,Alleghe
Giffoni Valle Piana,2,1,3,2005,Giffoni Valle Piana,Giffoni Valle Piana
Madonna del Ghisallo,2,1,3,2006,Madonna del Ghisallo,Magreglio
Domodossola,1,2,3,2006,Domodossola,Domodossola
Cantù,2,1,3,2007,Cantù,Cantù
Rivisondoli,2,1,3,2008,Rivisondoli,Rivisondoli
San Vincenzo,1,2,3,2008,San Vincenzo,San Vincenzo
Innsbruck,2,1,3,2009,Innsbruck,Estero
Vesuvio,0,3,3,2009,Vesuvio,Ercolano
Brunico / Bruneck,3,0,3,2010,Brunico,Brunico/Bruneck
Savigliano,3,0,3,2010,Savigliano,Savigliano
Lucera,2,1,3,2010,Lucera,Lucera
Porto Recanati,2,1,3,2010,Porto Recanati,Porto Recanati
Montalcino,1,2,3,2010,Montalcino,Montalcino
Peio,1,2,3,2010,Peio,Peio
Plan de Corones / Kronplatz - Passo Furcia,0,3,3,2010,Plan de Corones,Marebbe/Enneberg
Sapri,2,1,3,2011,Sapri,Sapri
Castelfidardo,1,2,3,2011,Castelfidardo,Castelfidardo
Nevegal,0,3,3,2011,Nevegal,Belluno
Recanati,2,1,3,2012,Recanati,Recanati
Lago Laceno,0,3,3,2012,Lago Laceno,Bagnoli Irpino
Busseto,2,1,3,2013,Busseto,Busseto
Ischia,2,1,3,2013,Ischia,Ischia
Tarvisio,2,1,3,2013,Tarvisio,Tarvisio
Fossano,2,1,3,2014,Fossano,Fossano
Lugo,2,1,3,2014,Lugo,Lugo
Montecampione,0,3,3,2014,Montecampione,Artogne
Castiglione della Pescaia,2,1,3,2015,Castiglione della Pescaia,Castiglione della Pescaia
Madonna di Campiglio,1,2,3,2015,Madonna di Campiglio,Pinzolo
Andalo,1,2,3,2016,Andalo,Andalo
Monza,2,1,3,2017,Monza,Monza
Caltanissetta,2,1,3,2018,Caltanissetta,Caltanissetta
Sappada,1,2,3,2018,Sappada,Sappada
Prato Nevoso,0,3,3,2018,Prato Nevoso,Frabosa Sottana
Orbetello,2,1,3,2019,Orbetello,Orbetello
Tortoreto Lido,2,1,3,2019,Tortoreto Lido,Tortoreto
Courmayeur,1,2,3,2019,Courmayeur,Courmayeur
Portorose / Portorož,1,1,2,1922,Portorož,Estero
Fiume / Rijeka,1,1,2,1924,Rijeka,Estero
Legnago,1,1,2,1936,Legnago,Legnago
San Severo,1,1,2,1937,San Severo,San Severo
Recoaro Terme,1,1,2,1938,Recoaro Terme,Recoaro Terme
Abbazia / Opatija,1,1,2,1940,Opatija,Estero
Alassio,1,1,2,1951,Alassio,Alassio
Bordighera,1,1,2,1953,Bordighera,Bordighera
Cannes,1,1,2,1955,Cannes,Estero
Sion,1,1,2,1957,Sion,Estero
Casale Monferrato,1,1,2,1962,Casale Monferrato,Casale Monferrato
Frabosa Soprana,1,1,2,1962,Frabosa Soprana,Frabosa Soprana
Leukerbad,1,1,2,1963,Leukerbad,Estero
Riolo Terme,1,1,2,1963,Riolo Terme,Riolo Terme
Lavarone,1,1,2,1964,Lavarone,Lavarone
Maratea,1,1,2,1965,Maratea,Maratea
Saas Fee,1,1,2,1965,Saas Fee,Estero
Abbadia San Salvatore,1,1,2,1968,Abbadia San Salvatore,Abbadia San Salvatore
Folgarida,1,1,2,1969,Folgarida,Dimaro Folgarida
Rocca Pietore,2,0,2,1970,Rocca Pietore,Rocca Pietore
Comerio,1,1,2,1970,Comerio,Comerio
Malcesine,1,1,2,1970,Malcesine,Malcesine
Chioggia,1,1,2,1971,Chioggia,Chioggia
Falcade,1,1,2,1971,Falcade,Falcade
Lainate,1,1,2,1971,Lainate,Lainate
Pescasseroli,1,1,2,1971,Pescasseroli,Pescasseroli
Montesano sulla Marcellana,1,1,2,1972,Montesano sulla Marcellana,Montesano sulla Marcellana
Alba Adriatica,1,1,2,1973,Alba Adriatica,Alba Adriatica
Luxembourg,1,1,2,1973,Luxembourg,Estero
Pietra Ligure,1,1,2,1974,Pietra Ligure,Pietra Ligure
Valenza,1,1,2,1974,Valenza,Valenza
Padula,1,1,2,1975,Padula,Padula
Pontoglio,1,1,2,1975,Pontoglio,Pontoglio
Arcore,1,1,2,1976,Arcore,Arcore
Arosio,1,1,2,1976,Arosio,Arosio
Terme di Comano,1,1,2,1976,Terme di Comano,Comano Terme
Binago,1,1,2,1977,Binago,Binago
Inverigo,1,1,2,1978,Inverigo,Inverigo
Modigliana - Monte Trebbio,1,1,2,1978,Modigliana,Modigliana
Castel Gandolfo,0,2,2,1979,Castel Gandolfo,Castel Gandolfo
Campi Salentina,1,1,2,1980,Campi Salentina,Campi Salentina
Gatteo,1,1,2,1980,Gatteo,Gatteo
Palinuro,1,1,2,1980,Palinuro,Centola
Borno,1,1,2,1981,Borno,Borno
Cascia,1,1,2,1981,Cascia,Cascia
Dimaro,1,1,2,1981,Dimaro,Dimaro Folgarida
Castellammare di Stabia,1,1,2,1982,Castellammare di Stabia,Castellammare di Stabia
Bibbiena,1,1,2,1983,Bibbiena,Bibbiena
Montefiascone,1,1,2,1983,Montefiascone,Montefiascone
Soave,2,0,2,1984,Soave,Soave
Agropoli,1,1,2,1984,Agropoli,Agropoli
Cecina,1,1,2,1985,Cecina,Cecina
Paola,1,1,2,1985,Paola,Paola
Villa San Giovanni,2,0,2,1986,Villa San Giovanni,Villa San Giovanni
Foppolo,1,1,2,1986,Foppolo,Foppolo
Nicotera,1,1,2,1986,Nicotera,Nicotera
Sauze d'Oulx,1,1,2,1986,Sauze d'Oulx,Sauze d'Oulx
Sciacca,1,1,2,1986,Sciacca,Sciacca
Sessa Aurunca - Cellole,1,1,2,1986,Cellole,Cellole
Trescore Balneario,1,1,2,1987,Trescore Balneario,Trescore Balneario
Chiesa in Valmalenco,1,1,2,1988,Chiesa in Valmalenco,Chiesa in Valmalenco
Santa Maria Capua Vetere,1,1,2,1988,Santa Maria Capua Vetere,Santa Maria Capua Vetere
Misurina,2,0,2,1989,Misurina,Auronzo di Cadore
Monte Generoso,0,2,2,1989,Monte Generoso,Estero
Ercolano,2,0,2,1990,Ercolano,Ercolano
Gallarate,1,1,2,1990,Gallarate,Gallarate
Klagenfurt am Wörthersee,1,1,2,1990,Klagenfurt am Wörthersee,Estero
Nola,1,1,2,1990,Nola,Nola
Sora,1,1,2,1990,Sora,Sora
Sacro Monte di Varese - Campo dei Fiori,0,2,2,1990,Campo dei Fiori Varese,Varese
San Giovanni di Fassa (Pozza e Vigo),2,0,2,1991,San Giovanni di Fassa,San Giovanni di FassaSèn Jan
Langhirano,0,2,2,1991,Langhirano,Langhirano
Aversa,1,1,2,1992,Aversa,Aversa
Palazzolo sull'Oglio,1,1,2,1992,Palazzolo sull'Oglio,Palazzolo sull'Oglio
Vercelli,1,1,2,1992,Vercelli,Vercelli
Vicopisano - Uliveto terme,1,1,2,1992,Vicopisano,Vicopisano
Pila,0,2,2,1992,Pila,Pila
Villafranca Tirrena,2,0,2,1993,Villafranca Tirrena,Villafranca Tirrena
Dozza,1,1,2,1993,Dozza,Dozza
Borgo Val di Taro,0,2,2,1993,Borgo Val di Taro,Borgo Val di Taro
Kranj,1,1,2,1994,Kranj,Estero
Lavagna,1,1,2,1994,Lavagna,Lavagna
Les Deux Alpes,1,1,2,1994,Les Deux Alpes,Estero
Lenzerheide,1,1,2,1995,Lenzerheide,Estero
Luino,1,1,2,1995,Luino,Luino
Senales / Schnals,1,1,2,1995,Senales,Senales/Schnals
Stradella,1,1,2,1995,Stradella,Stradella
Treviglio,1,1,2,1995,Treviglio,Treviglio
Selvino,0,2,2,1995,Selvino,Selvino
Atene / Αθήνα,1,1,2,1996,Athinia,Estero
Lausanne,1,1,2,1996,Lausanne,Estero
Loano,1,1,2,1996,Loano,Loano
Borgomanero,1,1,2,1997,Borgomanero,Borgomanero
Dalmine,1,1,2,1997,Dalmine,Dalmine
Mondragone,1,1,2,1997,Mondragone,Mondragone
Schio,1,1,2,1998,Schio,Schio
Predazzo,2,0,2,1999,Predazzo,Predazzo
Racconigi,2,0,2,1999,Racconigi,Racconigi
Bra,1,1,2,1999,Bra,Bra
Sassuolo,1,1,2,1999,Sassuolo,Sassuolo
Paestum,2,0,2,2000,Paestum,Capaccio Paestum
Saluzzo,2,0,2,2000,Saluzzo,Saluzzo
Montesilvano,2,0,2,2001,Montesilvano,Montesilvano
Montebelluna,1,1,2,2001,Montebelluna,Montebelluna
Nettuno,1,1,2,2001,Nettuno,Nettuno
Esch-sur-Alzette,1,1,2,2002,Esch-sur-Alzette,Estero
Folgaria,0,2,2,2002,Folgaria,Folgaria
Strasbourg,0,2,2,2002,Strasbourg,Estero
Salice Terme,1,1,2,2003,Salice Terme,Godiasco Salice Terme
San Donà di Piave,1,1,2,2003,San Donà di Piave,San Donà di Piave
Vibo Valentia,1,1,2,2003,Vibo Valentia,Vibo Valentia
Chianale,0,2,2,2003,Chianale,Pontechianale
Civitella in Val di Chiana,1,1,2,2004,Civitella in Val di Chiana,Civitella in Val di Chiana
Pontremoli,1,1,2,2004,Pontremoli,Pontremoli
San Vendemiano,1,1,2,2004,San Vendemiano,San Vendemiano
Diamante,1,1,2,2005,Diamante,Diamante
Lissone,1,1,2,2005,Lissone,Lissone
Limone Piemonte,0,2,2,2005,Limone Piemonte,Limone Piemonte
Val di Zoldo,0,2,2,2005,Val di Zoldo,Val di Zoldo
Seraing,1,1,2,2006,Seraing,Estero
Teano,1,1,2,2007,Teano,Teano
Fiorano Modenese,0,2,2,2007,Fiorano Modenese,Fiorano Modenese
Cesano Maderno,2,0,2,2008,Cesano Maderno,Cesano Maderno
Milazzo,0,2,2,2008,Milazzo,Milazzo
Monte Pora - Presolana,0,2,2,2008,Presolana,Castione della Presolana
Passo Fedaia,0,2,2,2008,Passo Fedaia,Rocca Pietore
Grado,2,0,2,2009,Grado,Grado
Mestre,2,0,2,2010,Mestre,Venezia
Großglockner,0,2,2,2011,Großglockner,Estero
Rifugio Gardeccia,0,2,2,2011,Rifugio Gardeccia,San Giovanni di FassaSèn Jan
Tropea,0,2,2,2011,Tropea,Tropea
Civitavecchia,2,0,2,2012,Civitavecchia,Civitavecchia
Horsens,1,1,2,2012,Horsens,Estero
Pian dei Resinelli,0,2,2,2012,Pian dei Resinelli,Abbadia Lariana
Cervere,1,1,2,2013,Cervere,Cervere
Cherasco,1,1,2,2013,Cherasco,Cherasco
Riese Pio X,1,1,2,2013,Riese Pio X,Riese Pio X
Saltara,0,2,2,2013,Saltara,Colli al Metauro
Collecchio,2,0,2,2014,Collecchio,Collecchio
Monte Grappa,0,2,2,2014,Monte Grappa,Pieve del Grappa
Valdobbiadene,0,2,2,2015,Valdobbiadene,Valdobbiadene
Bressanone / Brixen,2,0,2,2016,Bressanone,Bressanone/Brixen
Campi Bisenzio,2,0,2,2016,Campi Bisenzio,Campi Bisenzio
Apeldoorn,1,1,2,2016,Apeldoorn,Estero
Arnheim,1,1,2,2016,Arnheim,Estero
Cassano d'Adda,1,1,2,2016,Cassano d'Adda,Cassano d'Adda
Nijmegen,1,1,2,2016,Nijmegen,Estero
Alpe di Siusi / Seiser Alm,0,2,2,2016,Alpe di Siusi,Castelrotto/Kastelruth
Asolo,0,2,2,2016,Asolo,Asolo
Rovetta,2,0,2,2017,Rovetta,Rovetta
Valdengo,2,0,2,2017,Valdengo,Valdengo
Tortoli,1,1,2,2017,Tortoli,Tortolì
Piancavallo,0,2,2,2017,Piancavallo,Aviano
Tortona,0,2,2,2017,Tortona,Tortona
Pizzo,2,0,2,2018,Pizzo,Pizzo
Venaria Reale,2,0,2,2018,Venaria Reale,Venaria Reale
Jerusalem,1,1,2,2018,Jerusalem,Estero
Susa,1,1,2,2018,Susa,Susa
Ivrea,1,1,2,2019,Ivrea,Ivrea
Predappio,1,0,1,1928,Predappio,Predappio
Rocca di Papa,0,1,1,1952,Rocca di Papa,Rocca di Papa
Superga,0,1,1,1958,Superga,Torino
Seregno,1,0,1,1960,Seregno,Seregno
Castellana Grotte,1,0,1,1961,Castellana Grotte,Castellana Grotte
Gaeta,1,0,1,1961,Gaeta,Gaeta
Marsala,1,0,1,1961,Marsala,Marsala
Mentana,1,0,1,1961,Mentana,Mentana
Castrocaro Terme,0,1,1,1962,Castrocaro Terme,Castrocaro Terme e Terra del Sole
Marliana,0,1,1,1962,Marliana,Marliana
Passo Rolle,0,1,1,1962,Passo Rolle,Primiero San Martino di Castrozza
Pedavena,0,1,1,1964,Pedavena,Pedavena
Monte-Carlo,1,0,1,1966,Monte-Carlo,Estero
Bezzecca,0,1,1,1966,Bezzecca,Ledro
Triora - Monesi,0,1,1,1966,Triora,Triora
San Giorgio Piacentino,1,0,1,1968,San Giorgio Piacentino,San Giorgio Piacentino
San Cristoforo al Lago,0,1,1,1968,San Cristoforo al Lago,Pergine Valsugana
Celle Ligure,1,0,1,1969,Celle Ligure,Celle Ligure
Garda,1,0,1,1969,Garda,Garda
Brentonico,0,1,1,1970,Brentonico,Brentonico
Desenzano del Garda,1,0,1,1971,Desenzano del Garda,Desenzano del Garda
Porto San Giorgio,1,0,1,1972,Porto San Giorgio,Porto San Giorgio
Solda,1,0,1,1972,Stelvio,Stelvio/Stilfs
Fermo,0,1,1,1972,Fermo,Fermo
Genève,1,0,1,1973,Genève,Estero
Città del Vaticano,1,0,1,1974,Città del Vaticano,Estero
Omegna,1,0,1,1975,Omegna,Omegna
Monte Maddalena,0,1,1,1975,Monte Maddalena,Brescia
Prati di Tivo,0,1,1,1975,Prati di Tivo,Pietracamela
Bagnoli Irpino,1,0,1,1976,Bagnoli Irpino,Bagnoli Irpino
Castellamonte,1,0,1,1976,Castellamonte,Castellamonte
Selva Fasano,1,0,1,1976,Selva Fasano,Fasano
Ozegna,0,1,1,1976,Ozegna,Ozegna
Lago Miseno,1,0,1,1977,Lago Miseno,Bacoli
Bacoli,0,1,1,1977,Bacoli,Bacoli
Monte di Procida,0,1,1,1977,Monte di Procida,Monte di Procida
Roburent,0,1,1,1977,Roburent,Roburent
Varzi,0,1,1,1977,Varzi,Varzi
Amalfi,1,0,1,1978,Amalfi,Amalfi
Larciano,1,0,1,1978,Larciano,Larciano
Mazzin di Fassa,1,0,1,1978,Mazzin di Fassa,Mazzin
Mezzolombardo,1,0,1,1978,Mezzolombardo,Mezzolombardo
Poggibonsi,1,0,1,1978,Poggibonsi,Poggibonsi
Cascina,0,1,1,1978,Cascina,Cascina
Lago di Piediluco,0,1,1,1978,Lago di Piediluco,Terni
Ravello,0,1,1,1978,Ravello,Ravello
Sarezzo,0,1,1,1978,Sarezzo,Sarezzo
Barzio,0,1,1,1979,Barzio,Barzio
Portovenere,0,1,1,1979,Portovenere,Portovenere
Rio,1,0,1,1980,Rio,Rio
Saronno,1,0,1,1980,Saronno,Saronno
Villapiana,1,0,1,1980,Villapiana,Villapiana
Barletta,0,1,1,1980,Barletta,Barletta
Morano Calabro - Campotenese,0,1,1,1980,Morano Calabro,Morano Calabro
Turbigo,0,1,1,1980,Turbigo,Turbigo
Empoli,1,0,1,1981,Empoli,Empoli
San Vito Chietino,1,0,1,1981,San Vito Chietino,San Vito Chietino
Arzignano,0,1,1,1981,Arzignano,Arzignano
Fiera di Primiero,1,0,1,1982,Fiera di Primiero,Primiero San Martino di Castrozza
Palmi,1,0,1,1982,Palmi,Palmi
Piamborno,1,0,1,1982,Piamborno,Piancogno
Cortona,0,1,1,1982,Cortona,Cortona
Spezzano della Sila,0,1,1,1982,Spezzano della Sila,Spezzano della Sila
Sarnico,1,0,1,1983,Sarnico,Sarnico
Colli di San Fermo,0,1,1,1983,Colli di San Fermo,Grone
Todi,0,1,1,1983,Todi,Todi
Certosa di Pavia,1,0,1,1984,Certosa di Pavia,Certosa di Pavia
Pisticci,0,1,1,1984,Pisticci,Pisticci
Capua,1,0,1,1985,Capua,Capua
Cogne,0,1,1,1985,Cogne,Cogne
Jesi,0,1,1,1985,Jesi,Jesi
Sinalunga,1,0,1,1986,Sinalunga,Sinalunga
Castiglione del Lago,0,1,1,1986,Castiglione del Lago,Castiglione del Lago
Sarzana,0,1,1,1986,Sarzana,Sarzana
Pienza,1,0,1,1988,Pienza,Pienza
Spondigna / Spondinig,1,0,1,1988,Spondigna,Sluderno/Schluderns
Merano 2000 / Meran 2000,0,1,1,1988,Merano 2000,Avelengo/Hafling
Vetriolo,0,1,1,1988,Vetriolo,Levico Terme
Scilla,1,0,1,1989,Scilla,Scilla
Gubbio,0,1,1,1989,Gubbio,Gubbio
Mira,0,1,1,1989,Mira,Mira
Grinzane Cavour,1,0,1,1990,Grinzane Cavour,Grinzane Cavour
Reggello,1,0,1,1990,Reggello,Reggello
Velden am Wörthersee,1,0,1,1990,Velden am Wörthersee,Estero
Vallombrosa,0,1,1,1990,Vallombrosa,Reggello
Broni,1,0,1,1991,Broni,Broni
Sala Baganza,1,0,1,1991,Sala Baganza,Sala Baganza
Casteggio,0,1,1,1991,Casteggio,Casteggio
Felino,0,1,1,1991,Felino,Felino
Pian del Re,0,1,1,1992,Pian del Re,Crissolo
Capo d'Orlando,1,0,1,1993,Capo d'Orlando,Capo d'Orlando
Lago di Scanno,1,0,1,1993,Lago di Scanno,Scanno
Montelibretti,1,0,1,1993,Montelibretti,Montelibretti
Porto Azzurro,1,0,1,1993,Porto Azzurro,Porto Azzurro
Sampeyre,1,0,1,1993,Sampeyre,Sampeyre
Marcianise,0,1,1,1993,Marcianise,Marcianise
Santa Maria della Versa,1,0,1,1994,Santa Maria della Versa,Santa Maria della Versa
Loreto Aprutino,0,1,1,1994,Loreto Aprutino,Loreto Aprutino
Passo del Bocco,0,1,1,1994,Passo del Bocco,Mezzanego
Acquappesa,1,0,1,1995,Acquappesa,Acquappesa
Borgo a Mozzano,1,0,1,1995,Borgo a Mozzano,Borgo a Mozzano
Cenate Sotto,1,0,1,1995,Cenate Sotto,Cenate Sotto
Latronico,1,0,1,1995,Latronico,Latronico
Mondolfo,1,0,1,1995,Mondolfo,Mondolfo
Pieve di Cento,1,0,1,1995,Pieve di Cento,Pieve di Cento
Pont-Saint-Martin,1,0,1,1995,Pont-Saint-Martin,Pont-Saint-Martin
Telese Terme,1,0,1,1995,Telese Terme,Telese Terme
Trani,1,0,1,1995,Trani,Trani
Cento,0,1,1,1995,Cento,Cento
Gressoney-Saint-Jean,0,1,1,1995,Gressoney-Saint-Jean,Gressoney-Saint-Jean
Marotta,0,1,1,1995,Marotta,Mondolfo
Pontechianale,0,1,1,1995,Pontechianale,Pontechianale
Amantea,1,0,1,1996,Amantea,Amantea
Aulla,1,0,1,1996,Aulla,Aulla
Eleusi / Ελευσίνα,1,0,1,1996,Elefsina,Estero
Metaponto,1,0,1,1996,Metaponto,Bernalda
Missolungi / Μεσολόγγι,1,0,1,1996,Mesolongi,Estero
Polla,1,0,1,1996,Polla,Polla
Giannina / Ιωάννινα,0,1,1,1996,Ioànnina,Estero
Lepanto / Ναύπακτος,0,1,1,1996,Nàfpaktos,Estero
Malé,1,0,1,1997,Malé,Malé
Santarcangelo di Romagna,1,0,1,1997,Santarcangelo di Romagna,Santarcangelo di Romagna
Verres,1,0,1,1997,Verres,Verrès
Edolo,0,1,1,1997,Edolo,Edolo
Montella,1,0,1,1998,Montella,Montella
Lauria,1,0,1,1999,Lauria,Lauria
Noto,1,0,1,1999,Noto,Noto
Borgo San Dalmazzo,0,1,1,1999,Borgo San Dalmazzo,Borgo San Dalmazzo
Modica,0,1,1,1999,Modica,Modica
Corinaldo,1,0,1,2000,Corinaldo,Corinaldo
San Marcello Piteglio,1,0,1,2000,San Marcello Piteglio,San Marcello Piteglio
Bled,1,0,1,2001,Bled,Estero
Erbusco,1,0,1,2001,Erbusco,Erbusco
Fossacesia,1,0,1,2001,Fossacesia,Fossacesia
Gradisca d'Isonzo,1,0,1,2001,Gradisca d'Isonzo,Gradisca d'Isonzo
Montevarchi,0,1,1,2001,Montevarchi,Montevarchi
Cambiago,1,0,1,2002,Cambiago,Cambiago
Capannori,1,0,1,2002,Capannori,Capannori
Terme Euganee,1,0,1,2002,Terme Euganee,Abano Terme
Ans,0,1,1,2002,Ans,Estero
Monticello Brianza,0,1,1,2002,Monticello Brianza,Monticello Brianza
Münster,0,1,1,2002,Münster,Estero
Valle Castellana,0,1,1,2002,Valle Castellana,Valle Castellana
Canelli,1,0,1,2003,Canelli,Canelli
Cannobio,1,0,1,2003,Cannobio,Cannobio
Copertino,1,0,1,2003,Copertino,Copertino
Cascata del Toce,0,1,1,2003,Cascata del Toce,Formazza
Clusone,1,0,1,2004,Clusone,Clusone
Parenzo / Poreč,1,0,1,2004,Poreč,Estero
Bormio 2000,0,1,1,2004,Bormio 2000,Bormio
Carovigno,0,1,1,2004,Carovigno,Carovigno
Corno alle Scale,0,1,1,2004,Corno alle Scale,Lizzano in Belvedere
Fondo - Sarnonico,0,2,2,2014,Sarnonico,Sarnonico
Pola / Pula,0,1,1,2004,Pula,Estero
Valmontone,0,1,1,2004,Valmontone,Valmontone
Celano,1,0,1,2005,Celano,Celano
Chieri,1,0,1,2005,Chieri,Chieri
Egna / Neumarkt,1,0,1,2005,Egna,Egna/Neumarkt
Lamporecchio,1,0,1,2005,Lamporecchio,Lamporecchio
Mezzocorona,1,0,1,2005,Mezzocorona,Mezzocorona
Rossano Veneto,0,1,1,2005,Rossano Veneto,Rossano Veneto
Santa Maria del Cedro,0,1,1,2005,Santa Maria del Cedro,Santa Maria del Cedro
Mergozzo,1,0,1,2006,Mergozzo,Mergozzo
Mons,1,0,1,2006,Mons,Estero
Perwez,1,0,1,2006,Perwez,Estero
Rovato,1,0,1,2006,Rovato,Rovato
Sillian,1,0,1,2006,Sillian,Estero
Termeno / Tramin an der Weinstraße,1,0,1,2006,Termeno,Termeno sulla strada del vino/Tramin an der Weinstraße
Wanze,1,0,1,2006,Wanze,Estero
Charleroi,0,1,1,2006,Charleroi,Estero
Hotton,0,1,1,2006,Hotton,Estero
La Thuile,0,1,1,2006,La Thuile,La Thuile
Namur,0,1,1,2006,Namur,Estero
Passo Lanciano,0,1,1,2006,Passo Lanciano,Pretoro
Passo San Pellegrino,0,1,1,2006,Passo San Pellegrino,Moena
Agordo,1,0,1,2007,Agordo,Agordo
Barberino del Mugello,1,0,1,2007,Barberino del Mugello,Barberino di Mugello
Bardolino,1,0,1,2007,Bardolino,Bardolino
Barumini,1,0,1,2007,Barumini,Barumini
Caprera,1,0,1,2007,Caprera,La Maddalena
Scalenghe,1,0,1,2007,Scalenghe,Scalenghe
Serravalle Scrivia,1,0,1,2007,Serravalle Scrivia,Serravalle Scrivia
Tempio Pausania,1,0,1,2007,Tempio Pausania,Tempio Pausania
Vestone,1,0,1,2007,Vestone,Vestone
Bosa,0,1,1,2007,Bosa,Bosa
Comano Terme,0,1,1,2007,Comano Terme,Comano Terme
La Maddalena,0,1,1,2007,La Maddalena,La Maddalena
Santuario della Madonna della Guardia,0,1,1,2007,Santuario della Madonna della Guardia,Ceranesi
Scarperia,0,1,1,2007,Scarperia,Scarperia e San Piero
Belvedere Marittimo,1,0,1,2008,Belvedere Marittimo,Belvedere Marittimo
Legnano,1,0,1,2008,Legnano,Legnano
Urbania,1,0,1,2008,Urbania,Urbania
Cittadella,0,1,1,2008,Cittadella,Cittadella
Contursi Terme,0,1,1,2008,Contursi Terme,Contursi Terme
Pescocostanzo,0,1,1,2008,Pescocostanzo,Pescocostanzo
Pergola,1,0,1,2009,Pergola,Pergola
Anagni,0,1,1,2009,Anagni,Anagni
Chiavenna,0,1,1,2009,Chiavenna,Chiavenna
Mayrhofen,0,1,1,2009,Mayrhofen,Estero
Monte Petrano,0,1,1,2009,Monte Petrano,Cagli
Riomaggiore,0,1,1,2009,Riomaggiore,Riomaggiore
Città Sant'Angelo,1,0,1,2010,Città Sant'Angelo,Città Sant'Angelo
Fidenza,1,0,1,2010,Fidenza,Fidenza
Bitonto,0,1,1,2010,Bitonto,Bitonto
Middelburg,0,1,1,2010,Middelburg,Estero
Utrecht,0,1,1,2010,Utrecht,Estero
Piombino,1,0,1,2011,Piombino,Piombino
Quarto dei Mille,1,0,1,2011,Quarto dei Mille,Genova
Spilimbergo,1,0,1,2011,Spilimbergo,Spilimbergo
Macugnaga,0,1,1,2011,Macugnaga,Macugnaga
Caldes,1,0,1,2012,Caldes,Caldes
Limone sul Garda,1,0,1,2012,Limone sul Garda,Limone sul Garda
San Vito di Cadore,1,0,1,2012,San Vito di Cadore,San Vito di Cadore
Seravezza,1,0,1,2012,Seravezza,Seravezza
Vedelago,0,1,1,2012,Vedelago,Vedelago
Caravaggio,1,0,1,2013,Caravaggio,Caravaggio
Cesana Torinese,1,0,1,2013,Cesana Torinese,Cesana Torinese
Cordenons,1,0,1,2013,Cordenons,Cordenons
Marina di San Salvo,1,0,1,2013,Marina di San Salvo,San Salvo
Mola di Bari,1,0,1,2013,Mola di Bari,Mola di Bari
Mori,1,0,1,2013,Mori,Mori
Policastro Bussentino,1,0,1,2013,Policastro Bussentino,Santa Marina
Silandro / Schlanders,1,0,1,2013,Silandro,Silandro/Schlanders
Valloire,1,0,1,2013,Valloire,Estero
Forio,0,1,1,2013,Forio,Forio
Galibier,0,1,1,2013,Galibier,Estero
Margherita di Savoia,0,1,1,2013,Margherita di Savoia,Margherita di Savoia
Marina di Ascea,0,1,1,2013,Marina di Ascea,Ascea
Montasio,0,1,1,2013,Montasio,Chiusaforte
Polsa,0,1,1,2013,Polsa,Brentonico
Serra San Bruno,0,1,1,2013,Serra San Bruno,Serra San Bruno
Vajont,0,1,1,2013,Vajont,Erto e Casso
Agliè,1,0,1,2014,Agliè,Agliè
Armagh,1,0,1,2014,Armagh,Estero
Barbaresco,1,0,1,2014,Barbaresco,Barbaresco
Giovinazzo,1,0,1,2014,Giovinazzo,Giovinazzo
Maniago,1,0,1,2014,Maniago,Maniago
Montecassino,1,0,1,2014,Montecassino,Cassino
Sassano,1,0,1,2014,Sassano,Sassano
Barolo,0,1,1,2014,Barolo,Barolo
Dublin,0,1,1,2014,Dublin,Estero
Montecopiolo,0,1,1,2014,Montecopiolo,Montecopiolo
Panarotta,0,1,1,2014,Panarotta,Pergine Valsugana
Rivarolo Canavese,0,1,1,2014,Rivarolo Canavese,Rivarolo Canavese
Val Martello / Martelltal,0,1,1,2014,Val Martello,Martello/Martell
Viggiano,0,1,1,2014,Viggiano,Viggiano
Albenga,1,0,1,2015,Albenga,Albenga
Gravellona Toce,1,0,1,2015,Gravellona Toce,Gravellona Toce
Melide,1,0,1,2015,Melide,Estero
Montecchio Maggiore,1,0,1,2015,Montecchio Maggiore,Montecchio Maggiore
San Lorenzo a Mare,1,0,1,2015,San Lorenzo a Mare,San Lorenzo al Mare
Alpago - Farra,1,0,1,2016,Farra d'Alpago,Alpago
Castelrotto / Kastelruth,1,0,1,2016,Castelrotto,Castelrotto/Kastelruth
Guillestre,1,0,1,2016,Guillestre,Estero
Molveno,1,0,1,2016,Molveno,Molveno
Muggiò,1,0,1,2016,Muggiò,Muggiò
Noale,1,0,1,2016,Noale,Noale
Palmanova,1,0,1,2016,Palmanova,Palmanova
Ponte,1,0,1,2016,Ponte,Ponte
Radda in Chianti,1,0,1,2016,Radda in Chianti,Radda in Chianti
Cividale del Friuli,0,1,1,2016,Cividale del Friuli,Cividale del Friuli
Greve in Chianti,0,1,1,2016,Greve in Chianti,Greve in Chianti
Risoul,0,1,1,2016,Risoul,Estero
Sant'Anna di Vinadio,0,1,1,2016,Sant'Anna di Vinadio,Vinadio
Alghero,1,0,1,2017,Alghero,Alghero
Castellania,1,0,1,2017,Castellania,Castellania
Molfetta,1,0,1,2017,Molfetta,Molfetta
Montenero di Bisaccia,1,0,1,2017,Montenero di Bisaccia,Montenero di Bisaccia
Pedara,1,0,1,2017,Pedara,Pedara
San Candido / Innichen,1,0,1,2017,San Candido,San Candido/Innichen
Alberobello,0,1,1,2017,Alberobello,Alberobello
Bagno di Romagna,0,1,1,2017,Bagno di Romagna,Bagno di Romagna
Montefalco,0,1,1,2017,Montefalco,Montefalco
Abbiategrasso,1,0,1,2018,Abbiategrasso,Abbiategrasso
Be'er Sheva,1,0,1,2018,Be'er Sheva,Estero
Haifa,1,0,1,2018,Haifa,Estero
Penne,1,0,1,2018,Penne,Penne
Pesco Sannita,1,0,1,2018,Pesco Sannita,Pesco Sannita
San Vito al Tagliamento,1,0,1,2018,San Vito al Tagliamento,San Vito al Tagliamento
Tolmezzo,1,0,1,2018,Tolmezzo,Tolmezzo
Caltagirone,0,1,1,2018,Caltagirone,Caltagirone
Eilat,0,1,1,2018,Eilat,Estero
Gualdo Tadino,0,1,1,2018,Gualdo Tadino,Gualdo Tadino
Nervesa della Battaglia,0,1,1,2018,Nervesa della Battaglia,Nervesa della Battaglia
Santa Ninfa,0,1,1,2018,Santa Ninfa,Santa Ninfa
Tel Aviv,0,1,1,2018,Tel Aviv,Estero
Cassino,1,0,1,2019,Cassino,Cassino
Commezzadura,1,0,1,2019,Commezzadura,Commezzadura
Lovere,1,0,1,2019,Lovere,Lovere
Valdaora / Olang,1,0,1,2019,Valdaora,Valdaora/Olang
Vinci,1,0,1,2019,Vinci,Vinci
Anterselva / Antholz,0,1,1,2019,Anterselva,Rasun-Anterselva/Rasen-Antholz
Ceresole Reale,0,1,1,2019,Ceresole Reale,Ceresole Reale
Croce d'Aune,0,1,1,2019,Croce d'Aune,Pedavena
Fucecchio,0,1,1,2019,Fucecchio,Fucecchio
San Giovanni Rotondo,0,1,1,2019,San Giovanni Rotondo,San Giovanni Rotondo
Santa Maria di Sala,0,1,1,2019,Santa Maria di Sala,Santa Maria di Sala